11
0	0 0
1	0 1	2,3
3	0 2	1,3 2,3
7	1 3	0,3 1,3 2,3
11	0 3	1,2 1,3 2,3
12	0 2	0,3 1,2
13	1 3	0,3 1,2 2,3
15	1 4	0,3 1,2 1,3 2,3
30	1 4	0,2 0,3 1,2 1,3
31	1 5	0,2 0,3 1,2 1,3 2,3
63	1 6	0,1 0,2 0,3 1,2 1,3 2,3
