0 0 0 0 0 0 0 
1 0 0 1 1 1 1 
3 0 1 1 2 2 2 
7 0 2 2 2 3 3 
15 0 3 3 3 3 4 
31 0 4 4 4 4 4 
35 1 1 1 5 5 5 
36 1 1 1 1 6 6 
37 1 1 2 2 7 7 
39 1 2 2 5 8 8 
44 1 2 2 6 6 9 
45 1 2 3 7 7 10 
47 1 3 3 8 8 11 
60 1 3 3 9 9 9 
61 1 3 4 10 10 10 
63 1 4 4 11 11 11 
102 2 2 2 2 12 12 
103 2 2 5 5 13 13 
106 2 2 6 7 7 14 
107 2 2 7 8 8 15 
110 2 3 7 7 12 16 
111 2 3 8 8 13 17 
120 2 2 9 9 9 9 
121 2 2 10 10 10 10 
122 2 3 9 10 14 14 
123 2 3 10 11 15 15 
126 2 4 10 10 16 16 
127 2 4 11 11 17 17 
238 3 3 12 12 12 18 
239 3 3 13 13 13 19 
246 3 3 14 14 16 16 
247 3 3 15 15 17 17 
254 3 4 16 16 16 18 
255 3 4 17 17 17 19 
510 4 4 18 18 18 18 
511 4 4 19 19 19 19 
615 5 5 5 5 20 20 
616 5 6 6 6 5 21 
617 5 6 7 7 8 22 
619 5 7 7 8 13 23 
623 5 8 8 8 20 24 
632 5 9 9 9 21 21 
633 5 9 10 10 22 22 
635 5 10 10 11 23 23 
639 5 11 11 11 24 24 
655 6 8 8 8 8 25 
656 6 6 6 6 6 6 
657 6 6 7 7 9 9 
659 6 7 7 10 10 14 
662 6 8 9 9 8 21 
663 6 8 10 10 11 22 
671 6 11 11 11 11 25 
684 7 7 7 7 7 26 
685 7 7 8 8 12 27 
687 7 8 8 13 13 28 
691 7 7 7 15 15 15 
692 7 7 9 9 14 14 
693 7 7 10 10 16 16 
694 7 8 9 14 15 22 
695 7 8 10 15 17 23 
700 7 10 10 14 14 26 
701 7 10 11 15 16 27 
703 7 11 11 17 17 28 
750 8 8 12 12 13 29 
751 8 8 13 13 20 30 
758 8 8 14 14 23 23 
759 8 8 15 15 24 24 
760 8 9 14 14 21 22 
761 8 9 15 15 22 25 
762 8 10 14 16 22 27 
763 8 10 15 17 23 28 
766 8 11 16 16 23 29 
767 8 11 17 17 24 30 
920 9 9 12 12 9 9 
921 9 9 13 13 21 21 
922 9 10 12 16 14 14 
923 9 10 13 17 22 22 
926 9 11 16 16 22 22 
927 9 11 17 17 25 25 
954 10 10 12 18 16 16 
955 10 10 13 19 23 23 
956 10 10 16 16 26 26 
957 10 10 17 17 27 27 
958 10 11 16 18 27 27 
959 10 11 17 19 28 28 
1022 11 11 18 18 29 29 
1023 11 11 19 19 30 30 
1743 12 13 13 13 13 31 
1749 12 14 15 14 15 27 
1751 12 15 15 16 17 29 
1759 12 17 17 17 17 31 
1775 13 13 13 20 20 32 
1780 13 14 14 21 22 23 
1781 13 14 15 22 23 28 
1783 13 15 15 23 24 30 
1788 13 16 16 22 22 29 
1789 13 16 17 23 23 31 
1791 13 17 17 24 24 32 
1880 14 14 14 14 14 14 
1881 14 14 15 22 22 26 
1883 14 15 15 25 27 27 
1884 14 16 16 14 16 16 
1885 14 16 17 22 23 27 
1887 14 17 17 25 28 28 
1915 15 15 15 28 28 28 
1916 15 16 16 26 27 27 
1917 15 16 17 27 28 29 
1919 15 17 17 28 30 30 
2012 16 16 18 16 16 18 
2013 16 16 19 23 23 29 
2014 16 17 18 27 27 29 
2015 16 17 19 28 28 31 
2046 17 17 18 29 29 31 
2047 17 17 19 30 30 32 
4060 18 18 18 18 18 18 
4061 18 18 19 29 29 29 
4063 18 19 19 31 31 31 
4095 19 19 19 32 32 32 
5871 20 20 20 20 20 33 
5872 20 21 21 21 21 20 
5873 20 21 22 22 22 24 
5875 20 22 22 23 23 30 
5879 20 23 23 23 24 32 
5887 20 24 24 24 24 33 
5905 21 21 21 21 21 21 
5907 21 22 21 22 22 22 
5911 21 23 22 22 25 23 
5919 21 24 25 25 25 24 
5941 22 22 22 22 27 27 
5943 22 23 22 23 28 28 
5948 22 23 22 26 26 23 
5949 22 23 25 27 27 29 
5950 22 24 22 27 27 24 
5951 22 24 25 28 28 30 
6007 23 23 23 23 30 30 
6010 23 23 26 27 27 28 
6011 23 23 27 28 28 31 
6014 23 24 27 27 29 30 
6015 23 24 28 28 30 32 
6142 24 24 29 29 29 32 
6143 24 24 30 30 30 33 
6654 25 25 29 29 29 29 
6655 25 25 30 30 30 30 
7071 26 28 28 28 28 28 
7100 27 27 27 27 27 27 
7101 27 27 28 28 29 29 
7103 27 28 28 30 30 31 
7166 28 28 29 29 31 31 
7167 28 28 30 30 32 32 
8157 29 29 30 29 29 30 
8159 29 30 30 31 31 32 
8191 30 30 30 32 32 33 
15870 31 31 31 31 31 31 
15871 31 31 32 32 32 32 
16383 32 32 32 32 33 33 
32767 33 33 33 33 33 33 
