0 0 0 0 0 
1 0 0 1 1 
3 0 1 1 2 
7 0 2 2 2 
11 1 1 1 3 
12 1 1 1 1 
13 1 1 2 2 
15 1 2 2 3 
30 2 2 2 2 
31 2 2 3 3 
63 3 3 3 3 
